11111111111112111111111111211111111111121111111111111
1B2212222222221222222222222222222222221222222222122W1
12121211111212121111211111211111211112121211111212121
12222222222212121222222221212222222212121222221222221
11121212121212221211111121212111111212221212121212111
12221312121212121222222221212222222312121212121212221
22111212121212121211111121212111111212121212121211122
12222212122222121222222222222222222212122222121222221
12111112121212121211111111211111111212121212121111121
12122223221212222222422221212222222222221212232222121
12121111111212121111211111211111211112111211111112121
12122222222212222222212222222221222222222212222222121
12221111111222111111212222222221211111111222111112221
12122222222212222222212211211221242222222212222222121
12111111111112111121112212221221112111111211111111121
22222222222222222222222222P22222222222222222222222222
12111111111112111121112212221221112111111211111111121
12122222222212222222212211211221222222222212222222121
12221111111224111111212222222221211111111222111113221
12122222222212222222212222222221222222222212222222121
12121111111212111111211111211111211111111211111112121
12122222221212222222222221212222222224221212222222121
12111112121212121211111111211111111212121212121111121
12222212122222121222222222222222222212122222121222221
22111212111112121211111121212111111212121111121211122
12221222222224221212222221212222221212222222222212221
12121212111112122212111111211111121222121111121212121
12221212122212111222222221212222222211121222121212221
11121212121212221211111122222111111212221212121212111
12222222222212121222222221212222322212121222221222221
12121211111212121111211111211111211112121211111212121
1I2212222223221222222222222222222222221222222222122C1
11111111111112111111111111211111111111121111111111111