11111111111112111111111111211111111111121111111111111
12221222222222122222222222222222222222122222222212221
12121211111212121111211111211111211112121211111212121
12222222222212121222222221212222222212121222221222221
11121212121212221211111122222111111212221212121212111
12221212121212111222222221212222222211121212121212221
22111212111112121211111121212111111212121111121211122
12222212122222121212222221212222222212122222121222221
12111112121212121212111111211111111212121212121111121
12122222221212222222222221212222222222221212222222121
12121111111212111111212122222121211111111211111112121
12122222222212222222212121212121222222222212222222121
12221111111222111111222222222222211111111222111112221
12122222222212222222212111.11121222222222212222222121
121111111111111121111121.....121111111211111111111121
222222222222222222222221.....122222222222222222222222
121111111111111121111121BWIC.121111111211111111111121
12122222222212222222212111111121222222222212222222121
12221111111222111111222222222222211111111222111112221
12122222222212222222212121212121222222222212222222121
12121111111212111111212122222121P11111111211111112121
12122222221212222222222221212222222222221212222222121
12111112121212121212111111211111111212121212121111121
12222212122222121212222221212222222212122222121222221
22111212111112121211111121212111111212121111121211122
12221222222222221112222221212222221112222222222212221
12121212111212122212111111211111121222121211121212121
12221212121212111222222221212222222211121212121212221
11121212121212221211111122222111111212221212121212111
12222222222212121222222221212222222212121222221222221
12121211111212121111211111211111211112121211111212121
12221222222222122222222222222222222222122222222212221
11111111111112111111111111211111111111121111111111111