1111111111111111111111111
1222222222222222222222221
1222222222222222222222221
1222222222222222222222221
1222222222222222222222221
1222222211111122222222221
1222222222222222222222221
1222222222222222222222221
1222222222222222222222221
1222222222222222222222221
1222222222222222222222221
1222222222222222222222221
1222222222222222222222221
122222222222P222222222221
1111111111111111111111111